+-------------+
|     |       |
|-- - | |-| | | 
|   |   | | | |
| | |---- |-- |
| |           |
| ------------|
|    |        |
|--- | | -----|
|      |      |
|------------ |
| |           |
|   ----------|
| |          $O
+-------------+
