+-------------+
|     |       |
|-- - | |-| | | 
|   |   | |2| |
| | |---- |-- |
| |           |
| ------------|
|    |       3|
|--- | | -----|
|      |      |
|-----------  |
|1|           |
|   ----------|
| |          $O
+-------------+
